TILEMAP
32 26 							-- Size of tile map in tiles
8 8 							-- Tile size & block size
images/Tiles.png 	-- Tilesheet
60 28 								-- Number of tiles in tilesheet
0 0 0 0 0 0 0 0 0 0 0 0 0 0 0 0 0 0 0 0 0 0 0 0 0 0 0 0 0 0 0 0 
0 0 0 0 0 0 0 0 0 0 0 0 0 0 0 0 0 0 0 0 0 0 0 0 0 0 0 0 0 0 0 0 
0 0 0 0 0 0 0 0 0 0 0 0 0 0 0 0 0 0 0 0 0 0 0 0 0 0 0 0 0 0 0 0 
0 0 0 0 0 0 0 0 0 0 0 0 0 0 0 0 0 0 0 0 0 0 0 0 0 0 0 0 0 0 0 0 
1495 1544 1665 1664 1665 1664 1665 1664 1665 1664 1665 1664 1665 1664 1665 1664 1665 1664 1665 1664 1665 1664 1665 1664 1665 1664 1665 1664 1665 1664 1545 1495 
1544 1546 0 0 0 0 0 0 0 0 0 0 0 0 0 0 0 0 0 0 0 0 0 0 0 0 0 0 0 0 1543 1545 
1546 1546 0 0 0 0 0 0 0 0 0 0 0 0 0 0 0 0 0 0 0 0 0 0 0 0 0 0 0 0 1603 1603 
1606 1606 0 0 0 0 0 0 0 0 0 0 0 0 0 0 0 0 0 0 0 0 0 0 0 0 0 0 0 0 1543 1543 
1546 1546 0 0 0 0 0 0 0 0 0 0 0 0 0 0 0 0 0 0 0 0 0 0 0 0 0 0 0 0 1603 1603 
1606 1606 0 0 0 0 0 0 1613 1614 1613 1614 1613 1614 1613 1614 1613 1614 1613 1614 1613 1614 1613 1614 0 0 0 0 0 0 1543 1543 
1546 1546 0 0 0 0 0 0 0 0 0 0 0 0 1483 1484 1485 1486 0 0 0 0 0 0 0 0 0 0 0 0 1603 1603 
1606 1606 0 0 0 0 0 0 0 0 0 0 0 0 1543 1544 1545 1546 0 0 0 0 0 0 0 0 0 0 0 0 1543 1543 
1546 1546 0 0 0 0 1613 1614 1613 1614 1613 1614 1613 1614 1603 1604 1605 1606 1613 1614 1613 1614 1613 1614 1613 1614 0 0 0 0 1603 1603 
1606 1606 0 0 0 0 0 0 0 0 0 0 0 0 1543 1544 1545 1546 0 0 0 0 0 0 0 0 0 0 0 0 1543 1543 
1546 1546 0 0 0 0 0 0 0 0 0 0 0 0 1603 1604 1605 1606 0 0 0 0 0 0 0 0 0 0 0 0 1603 1603 
1606 1606 0 0 1613 1614 1613 1614 1613 1614 1613 1614 1613 1614 1663 1664 1665 1666 1613 1614 1613 1614 1613 1614 1613 1614 1613 1614 0 0 1543 1543 
1546 1546 0 0 0 0 0 0 0 0 0 0 0 0 0 0 0 0 0 0 0 0 0 0 0 0 0 0 0 0 1603 1603 
1606 1606 0 0 0 0 0 0 0 0 0 0 0 0 0 0 0 0 0 0 0 0 0 0 0 0 0 0 0 0 1543 1543 
1546 1546 0 0 1613 1614 1613 1614 0 0 0 0 0 0 0 0 0 0 0 0 0 0 0 0 1613 1614 1613 1614 0 0 1603 1603 
1606 1606 0 0 0 0 0 0 0 0 0 0 0 0 0 0 0 0 0 0 0 0 0 0 0 0 0 0 0 0 1543 1543 
1546 1546 0 0 0 0 0 0 0 0 0 0 0 0 0 0 0 0 0 0 0 0 0 0 0 0 0 0 0 0 1603 1603 
1606 1606 0 0 1613 1614 0 0 0 0 0 0 0 0 0 0 0 0 0 0 0 0 0 0 0 0 1613 1614 0 0 1543 1543 
1546 1546 0 0 0 0 0 0 0 0 0 0 0 0 0 0 0 0 0 0 0 0 0 0 0 0 0 0 0 0 1603 1603 
1606 1606 0 0 0 0 0 0 0 0 0 0 0 0 0 0 0 0 0 0 0 0 0 0 0 0 0 0 0 0 1543 1543 
1604 1546 1613 1614 1613 1614 1613 1614 1613 1614 1613 1614 1669 1670 1669 1670 1669 1670 1669 1670 1613 1614 1613 1614 1613 1614 1613 1614 1613 1614 1543 1605 
1495 1604 1484 1485 1484 1485 1484 1485 1484 1485 1484 1485 1484 1485 1484 1485 1484 1485 1484 1485 1484 1485 1484 1485 1484 1485 1484 1485 1484 1485 1605 1495