TILEMAP
32 26 							-- Size of tile map in tiles
8 8 							-- Tile size & block size
images/Tiles.png 	-- Tilesheet
60 28 								-- Number of tiles in tilesheet
0 0 0 0 0 0 0 0 0 0 0 0 0 0 0 0 0 0 0 0 0 0 0 0 0 0 0 0 0 0 0 0 
0 0 0 0 0 0 0 0 0 0 0 0 0 0 0 0 0 0 0 0 0 0 0 0 0 0 0 0 0 0 0 0 
0 0 0 0 0 0 0 0 0 0 0 0 0 0 0 0 0 0 0 0 0 0 0 0 0 0 0 0 0 0 0 0 
0 0 0 0 0 0 0 0 0 0 0 0 0 0 0 0 0 0 0 0 0 0 0 0 0 0 0 0 0 0 0 0 
1544 1664 1665 1664 1665 1664 1665 1664 1665 1664 1665 1664 1665 1664 1665 1664 1665 1664 1665 1664 1665 1664 1665 1664 1665 1664 1665 1664 1665 1664 1665 1545 
1546 0 0 0 0 0 0 0 0 0 0 0 0 0 0 0 0 0 0 0 0 0 0 0 0 0 0 0 0 0 0 1603 
1606 0 0 0 0 0 0 0 0 0 0 0 0 0 0 0 0 0 0 0 0 0 0 0 0 0 0 0 0 0 0 1543 
1546 0 0 1483 1486 0 0 0 0 0 0 0 0 0 0 0 0 0 0 0 0 0 0 0 0 0 0 1483 1486 0 0 1603 
1606 1613 1614 1663 1666 0 0 0 0 0 0 0 0 0 0 0 0 0 0 0 0 0 0 0 0 0 0 1663 1666 1613 1614 1543 
1546 0 0 0 0 0 0 0 0 0 0 0 0 0 1613 1614 1613 1614 0 0 0 0 0 0 0 0 0 0 0 0 0 1603 
1606 0 0 0 0 0 0 0 0 0 0 0 0 0 0 0 0 0 0 0 0 0 0 0 0 0 0 0 0 0 0 1543 
1546 0 0 0 0 0 0 0 0 0 0 0 0 0 0 0 0 0 0 0 0 0 0 0 0 0 0 0 0 0 0 1603 
1606 0 0 0 0 1613 1614 1613 1614 1613 1614 1613 1614 1613 1614 0 0 1613 1614 1613 1614 1613 1614 1613 1614 1613 1614 0 0 0 0 1543 
1546 0 0 0 0 0 0 0 0 1483 1486 0 0 0 0 0 0 0 0 0 0 1483 1486 0 0 0 0 0 0 0 0 1603 
1606 1619 1620 0 0 0 0 0 0 1543 1606 0 0 0 0 0 0 0 0 0 0 1543 1606 0 0 0 0 0 0 1615 1616 1543 
1546 0 0 0 0 0 0 0 0 1543 1606 0 0 0 0 0 0 0 0 0 0 1543 1606 0 0 0 0 0 0 0 0 1603 
1606 1613 1614 1613 1614 1613 1614 1613 1614 1663 1666 0 0 0 0 0 0 0 0 0 0 1663 1666 1613 1614 1613 1614 1613 1614 1613 1614 1543 
1546 0 0 0 0 0 0 0 0 0 0 0 0 0 0 0 0 0 0 0 0 0 0 0 0 0 0 0 0 0 0 1603 
1606 0 0 0 0 0 0 0 0 0 0 0 0 1613 1614 1613 1614 1613 1614 0 0 0 0 0 0 0 0 0 0 0 0 1543 
1546 1613 1614 1613 1614 0 0 0 0 0 0 0 0 645 646 647 646 647 648 0 0 0 0 0 0 0 0 1613 1614 1613 1614 1603 
1606 0 0 0 0 0 0 0 0 1613 1614 1613 1614 705 706 707 706 707 708 1613 1614 1613 1614 0 0 0 0 0 0 0 0 1543 
1546 0 0 0 0 0 0 0 0 45 46 47 48 529 530 531 530 531 532 41 42 43 44 0 0 0 0 0 0 0 0 1603 
1606 0 0 0 0 1613 1614 1613 1614 105 106 107 108 589 590 591 590 591 592 101 102 103 104 1613 1614 1613 1614 0 0 0 0 1543 
1546 0 0 0 0 533 534 535 536 165 166 167 168 645 646 647 646 647 648 161 162 163 164 533 534 535 536 0 0 0 0 1603 
1606 1613 1614 1613 1614 593 594 595 596 225 226 227 228 705 706 707 706 707 708 221 222 223 224 593 594 595 596 1613 1614 1613 1614 1543 
1604 1484 1485 1484 1485 1484 1485 1484 1485 1484 1485 1484 1485 1484 1485 1484 1485 1484 1485 1484 1485 1484 1485 1484 1485 1484 1485 1484 1485 1484 1485 1605
