TILEMAP
32 26 							-- Size of tile map in tiles
8 8 							-- Tile size & block size
images/Tiles.png 	-- Tilesheet
60 28 								-- Number of tiles in tilesheet
1544 1664 1665 1664 1665 1664 1665 1664 1665 1664 1665 1664 1665 1664 1665 1664 1665 1664 1665 1664 1665 1664 1665 1664 1665 1664 1665 1664 1665 1664 1665 1545 
1606 1423 1423 1363 1364 1363 1364 1363 1364 1363 1364 1363 1364 1363 1364 1363 1364 1363 1364 1363 1364 1363 1364 1363 1364 1363 1364 1363 1364 1363 1424 1543 
1606 1423 1363 1364 1364 1363 1364 1363 1364 1363 1364 1363 1364 1363 1364 1363 1364 1363 1364 1363 1364 1363 1364 1363 1364 1363 1364 1363 1364 1363 1364 1543 
1604 1485 1484 1485 1484 1485 1484 1485 1484 1485 1484 1485 1484 1485 1484 1485 1484 1485 1484 1485 1484 1485 1484 1485 1484 1485 1484 1485 1484 1485 1484 1605 
1544 1664 1665 1664 1665 1664 1665 1664 1665 1664 1665 1664 1665 1664 1665 1664 1665 1664 1665 1664 1665 1664 1665 1664 1665 1664 1665 1664 1665 1664 1665 1545 
1546 1411 1411 1412 1413 1593 1415 1416 1411 1411 1412 1413 1414 1221 1222 1543 1606 1221 1222 1411 1411 1411 1411 1411 1411 1411 1412 1413 1414 1549 1550 1603 
1606 1471 1411 1411 1411 1411 1411 1411 1471 1411 1412 1536 1536 1281 1282 1603 1546 1281 1282 1471 1471 1471 1471 1471 1471 1471 1472 1473 1474 1609 1610 1543 
1546 1411 1411 1412 1413 1593 1415 1411 1531 1411 1411 1536 1536 1341 1342 1663 1666 1341 1342 1531 1531 1531 1531 1531 1531 1531 1532 1533 1534 1535 1536 1603 
1606 1411 1411 1412 1413 1593 1415 1411 1416 1241 1242 1536 1536 1401 1402 1591 1591 1401 1402 1412 1413 1241 1242 1412 1235 1236 1235 1236 1594 1595 1596 1543 
1546 1411 1411 1412 1413 1593 1415 1411 1416 1301 1302 1536 1536 1461 1462 1536 1651 1461 1462 1412 1413 1301 1302 1412 1295 1296 1295 1296 1654 1655 1656 1603 
1606 1411 1411 1412 1413 1593 1415 1411 1476 1361 1362 1613 1614 1613 1614 1416 1536 1613 1614 1613 1614 1361 1362 1411 1412 1235 1236 1415 1416 1596 1597 1543 
1546 1411 1411 1412 1413 1593 1415 1411 1536 1241 1242 1536 1536 1461 1462 1476 1476 1461 1462 1476 1476 1241 1242 1411 1412 1295 1296 1415 1416 1596 1597 1603 
1606 1613 1614 1613 1614 1613 1614 1411 1413 1301 1302 1536 1536 1521 1522 1476 1476 1521 1522 1476 1476 1301 1302 1411 1412 1613 1614 1613 1614 1613 1614 1543 
1604 1484 1485 1484 1485 1484 1486 1411 1413 1361 1362 1619 1620 1581 1582 1536 1536 1581 1582 1615 1616 1361 1362 1411 1412 1483 1485 1484 1485 1484 1485 1605 
1363 1426 1363 1363 1426 1424 1546 1412 1413 1421 1422 1679 1680 1641 1642 1596 1596 1641 1642 1675 1676 1421 1422 1411 1412 1603 1423 1426 1363 1363 1426 1364 
1544 1664 1665 1664 1665 1664 1666 1416 1416 1241 1242 1613 1614 1613 1614 1613 1614 1613 1614 1613 1614 1241 1242 1471 1411 1663 1665 1664 1665 1664 1665 1545 
1606 1491 1411 1412 1413 1593 1491 1416 1476 1301 1302 1416 1472 1472 1472 1472 1472 1412 1411 1471 1591 1301 1302 1531 1471 1491 1411 1412 1413 1593 1491 1543 
1546 1551 1411 1412 1413 1593 1551 1476 1536 1361 1362 1223 1224 1532 1532 1532 1532 1472 1471 1531 1651 1361 1362 1591 1531 1551 1411 1412 1413 1593 1551 1603 
1606 1611 1411 1412 1413 1593 1611 1536 1596 1421 1422 1613 1614 1613 1614 1613 1614 1613 1614 1613 1614 1421 1422 1651 1591 1611 1411 1412 1413 1593 1611 1543 
1546 1671 1411 1412 1413 1593 1671 1596 1656 1541 1542 1596 1416 1416 1416 1416 1416 1416 1591 873 874 1541 1542 1655 1651 1671 1411 1412 1413 1593 1671 1603 
1606 1613 1614 1613 1614 1613 1614 1656 1413 1601 1602 1656 1476 1476 1476 1223 1224 1476 1651 933 934 1601 1602 1476 1476 1613 1614 1613 1614 1613 1614 1543 
1546 1411 1411 1412 1413 1593 1415 1472 1473 1661 1662 1613 1614 1613 1614 1613 1614 1613 1614 1613 1614 1661 1662 1536 1536 1411 1411 1412 1413 1593 1415 1603 
1606 1411 1411 1412 1413 1593 1415 1532 1533 879 880 1531 1532 1534 1531 1532 1533 1531 1532 1533 1534 505 506 507 508 1596 1520 1520 1520 1536 1536 1543 
1546 1411 1411 1412 1413 1593 1415 1592 1593 939 940 1591 1531 1594 1591 1531 1532 1591 1592 1593 1594 565 566 567 568 1656 1520 1520 1520 1596 1596 1603 
1606 1669 1670 1669 1670 1669 1670 1613 1614 1613 1614 1613 1614 1613 1614 1613 1614 1613 1614 1613 1614 1613 1614 1613 1614 1669 1670 1669 1670 1669 1670 1543 
1604 1484 1485 1484 1485 1484 1485 1484 1485 1484 1485 1484 1485 1484 1485 1484 1485 1484 1485 1484 1485 1484 1485 1484 1485 1484 1485 1484 1485 1484 1485 1605
