TILEMAP
32 26 							-- Size of tile map in tiles
8 8 							-- Tile size & block size
images/Tiles.png 	-- Tilesheet
60 28 								-- Number of tiles in tilesheet
1544 1664 1665 1664 1665 1664 1665 1664 1665 1664 1665 1664 1665 1664 1665 1664 1665 1664 1665 1664 1665 1664 1665 1664 1665 1664 1665 1664 1665 1664 1665 1545 
1606 1423 1423 1363 1364 1363 1364 1363 1364 1363 1364 1363 1364 1363 1364 1363 1364 1363 1364 1363 1364 1363 1364 1363 1364 1363 1364 1363 1364 1363 1424 1543 
1606 1423 1363 1364 1364 1363 1364 1363 1364 1363 1364 1363 1364 1363 1364 1363 1364 1363 1364 1363 1364 1363 1364 1363 1364 1363 1364 1363 1364 1363 1424 1543 
1604 1485 1484 1485 1484 1485 1484 1485 1484 1485 1484 1485 1484 1485 1484 1485 1484 1485 1484 1485 1484 1485 1484 1485 1484 1485 1484 1485 1484 1485 1484 1605 
1544 1664 1665 1664 1665 1664 1665 1664 1665 1664 1665 1664 1665 1664 1665 1664 1665 1664 1665 1664 1665 1664 1665 1664 1665 1664 1665 1664 1665 1664 1665 1545 
1546 1231 1232 1471 1471 1471 1471 1471 1552 1473 1591 1235 1236 1552 1471 1471 1552 1473 1591 1471 1472 1473 1591 1591 1591 1552 1533 1552 1474 1231 1232 1603 
1606 1291 1292 1471 1471 1471 1471 1471 1612 1591 1591 1295 1296 1612 1472 1473 1612 1531 1532 517 518 519 520 1591 1593 1612 1593 1492 1473 1291 1292 1543 
1546 1531 1531 1531 1531 1471 1531 1471 1672 1375 1591 1591 1593 1672 1532 1533 1672 1591 1592 577 578 579 580 1591 1593 1672 1593 1552 1473 1474 1474 1603 
1606 1591 1591 1591 1591 1531 1591 1531 1613 1614 1613 1614 1613 1614 1592 1593 1613 1614 1613 1614 1613 1614 1613 1614 1613 1614 1474 1492 1473 1615 1616 1543 
1606 1591 1591 1591 1591 1531 1471 1532 1533 1591 1591 1591 1591 1531 1471 1532 25 26 27 28 1552 1474 1474 1474 1474 1474 1474 1552 1473 1675 1676 1603 
1546 1613 1614 1613 1614 1591 1531 1592 1593 1531 1532 1221 1222 1532 1471 1591 85 86 87 88 1492 1474 1474 1474 1474 1471 1471 1492 1533 1474 1474 1543 
1604 1484 1485 1484 1486 1375 1591 1376 1471 1472 1473 1281 1282 1355 1471 1591 145 146 147 148 1552 1474 1474 1474 1474 1471 1471 1552 1593 1474 1474 1603 
1423 1363 1363 1424 1546 1619 1620 1472 1531 1532 1533 1341 1342 1415 1471 1591 205 206 207 208 1612 1474 1474 513 514 515 516 1612 1473 1615 1616 1543 
1544 1664 1665 1664 1666 1679 1680 1532 1591 1592 1593 1461 1462 1475 1473 1471 1471 1471 1472 1471 1672 1474 1474 573 574 575 576 1672 1473 1675 1676 1603 
1546 1549 1550 1471 1472 1473 1531 1592 1593 1471 1471 1521 1522 1472 1473 1471 1471 1471 1471 1471 1613 1614 1613 1614 1613 1614 1613 1614 1533 1474 1474 1543 
1606 1609 1610 1471 1471 1472 1591 1103 1104 1531 1531 1581 1582 1532 1533 1531 1531 1471 1471 1471 1532 1533 1532 1533 1474 1474 1591 1593 1593 1471 1472 1603 
1606 1471 1472 1591 1591 1592 1593 1163 1164 1591 1591 1641 1642 1592 1593 1591 1591 1413 1414 1591 1592 1593 1351 1352 1353 1354 1235 1236 1353 1531 1532 1543 
1546 1471 1471 1472 1473 1615 1616 1613 1614 1613 1614 1613 1614 1613 1614 1613 1614 1613 1614 1101 1102 1412 1413 1412 1413 1414 1295 1296 1235 1236 1415 1603 
1606 879 880 1532 1533 1675 1676 1663 1664 1664 1665 1664 1665 1664 1665 1664 1665 1301 1302 1161 1162 1472 1473 1472 1473 1474 1235 1236 1295 1296 1475 1543 
1546 939 940 1592 1593 1471 1471 1471 1528 1471 1471 1471 1471 1472 1473 1552 1474 1361 1362 1619 1620 1413 1412 1532 1533 1534 1295 1296 1533 1615 1616 1603 
1606 1613 1614 1613 1614 1531 1531 1531 1588 1531 1531 1531 1531 1532 1533 1612 1474 1421 1422 1679 1680 1413 1412 1355 1356 1594 1591 1471 1472 1675 1676 1543 
1546 45 46 47 48 1591 1591 1591 1648 1471 1471 1471 1471 1472 1473 1672 1474 1481 1482 1471 1471 1413 1413 1412 1413 1531 1532 1531 1532 1591 1471 1603 
1606 105 106 107 108 1613 1614 1613 1614 1531 1531 1531 1531 1532 1533 1613 1614 1541 1542 1531 1531 1473 1473 1472 1473 1474 1474 1103 1104 1123 1124 1543 
1546 165 166 167 168 529 530 531 532 1591 1591 1591 1591 1592 1593 1474 1474 1601 1602 1591 1591 1412 1412 1532 1533 1474 1474 1163 1164 1183 1184 1603 
1606 225 226 227 228 589 590 591 592 1669 1670 1613 1614 1613 1614 1669 1670 1661 1662 1613 1614 1613 1614 1613 1614 1613 1614 1613 1614 1241 1242 1543 
1604 1484 1485 1484 1485 1484 1485 1484 1485 1484 1485 1484 1485 1484 1485 1484 1485 1484 1485 1484 1485 1484 1485 1484 1485 1484 1485 1484 1485 1484 1485 1605
