TILEMAP
32 26 							-- Size of tile map in tiles
8 8 							-- Tile size & block size
images/Tiles.png 	-- Tilesheet
60 28 								-- Number of tiles in tilesheet
0 0 0 0 0 0 0 0 0 0 0 0 0 0 0 0 0 0 0 0 0 0 0 0 0 0 0 0 0 0 0 0 
0 0 0 0 0 0 0 0 0 0 0 0 0 0 0 0 0 0 0 0 0 0 0 0 0 0 0 0 0 0 0 0 
0 0 0 0 0 0 0 0 0 0 0 0 0 0 0 0 0 0 0 0 0 0 0 0 0 0 0 0 0 0 0 0 
0 0 0 0 0 0 0 0 0 0 0 0 0 0 0 0 0 0 0 0 0 0 0 0 0 0 0 0 0 0 0 0 
1544 1664 1665 1664 1665 1664 1665 1664 1665 1664 1665 1664 1665 1664 1665 1664 1665 1664 1665 1664 1665 1664 1665 1664 1665 1664 1665 1664 1665 1664 1665 1545 
1546 0 0 0 0 0 0 0 0 0 0 0 0 0 0 0 0 0 0 0 0 0 0 0 0 0 0 0 0 0 0 1603 
1606 0 0 0 0 0 0 0 0 0 0 0 0 0 0 0 0 0 0 0 0 0 0 0 0 0 0 0 0 0 0 1543 
1546 0 0 0 0 0 0 0 0 0 0 0 0 0 0 0 0 0 0 0 0 0 0 0 0 0 0 0 0 0 0 1603 
1606 0 0 1613 1614 1613 1614 1613 1614 1613 1614 0 0 0 0 0 0 0 0 0 0 1613 1614 1613 1614 1613 1614 1613 1614 0 0 1543 
1546 0 0 0 0 0 0 0 0 0 0 0 0 0 0 0 0 0 0 0 0 0 0 0 0 0 0 0 0 0 0 1603 
1606 0 0 0 0 0 0 0 0 0 0 0 0 0 0 0 0 0 0 0 0 0 0 0 0 0 0 0 0 0 0 1543 
1546 0 0 0 0 1613 1614 1613 1614 1613 1614 1613 1614 1613 1614 1613 1614 1613 1614 1613 1614 1613 1614 1613 1614 1613 1614 0 0 0 0 1603 
1606 0 0 0 0 0 0 1241 1242 0 0 0 0 0 0 0 0 0 0 0 0 0 0 1241 1242 0 0 0 0 0 0 1543 
1546 0 0 0 0 0 0 1301 1302 0 0 0 0 0 0 0 0 0 0 1617 1618 1615 1616 1301 1302 0 0 0 0 0 0 1603 
1606 0 0 0 0 0 0 1361 1362 0 0 0 0 0 0 0 0 0 0 0 0 0 0 1361 1362 0 0 0 0 0 0 1543 
1546 0 0 0 0 0 0 1661 1662 1613 1614 1613 1614 1613 1614 1613 1614 1613 1614 1613 1614 1613 1614 1661 1662 0 0 0 0 0 0 1603 
1606 0 0 0 0 0 0 0 0 0 0 0 0 0 0 0 0 0 0 0 0 0 0 0 0 0 0 0 0 0 0 1543 
1546 0 0 0 0 0 0 0 0 0 0 0 0 0 0 0 0 0 0 0 0 0 0 0 0 0 0 0 0 0 0 1603 
1606 1613 1614 1613 1614 1613 1614 0 0 0 0 0 0 1613 1614 1613 1614 1613 1614 0 0 0 0 0 0 1613 1614 1613 1614 1613 1614 1543 
1546 0 0 0 0 0 0 0 0 0 0 0 0 0 0 0 0 0 0 0 0 0 0 0 0 0 0 0 0 0 0 1603 
1606 0 0 0 0 0 0 0 0 0 0 0 0 0 0 0 0 0 0 0 0 0 0 0 0 0 0 0 0 0 0 1543 
1546 0 0 0 0 1613 1614 1613 1614 1129 1130 1619 1620 0 0 0 0 0 0 0 0 1121 1122 1613 1614 1613 1614 0 0 0 0 1603 
1606 0 0 0 0 0 0 0 0 1189 1190 0 0 0 0 0 0 0 0 1129 1130 1181 1182 0 0 0 0 0 0 0 0 1543 
1546 0 0 0 0 0 0 0 0 1129 1130 0 0 0 0 0 0 0 0 1189 1190 1129 1130 0 0 0 0 0 0 0 0 1603 
1606 1613 1614 1613 1614 1669 1670 1669 1670 1189 1190 1613 1614 1613 1614 1613 1614 1613 1614 1544 1545 1189 1190 1613 1614 1613 1614 1613 1614 1613 1614 1543 
1604 1484 1485 1484 1485 1484 1485 1484 1485 1484 1485 1484 1485 1484 1485 1484 1485 1484 1485 1484 1485 1484 1485 1484 1485 1484 1485 1484 1485 1484 1485 1605
