TILEMAP
32 26 							-- Size of tile map in tiles
8 8 							-- Tile size & block size
images/Tiles.png 	-- Tilesheet
60 28 								-- Number of tiles in tilesheet
0 0 0 0 0 0 0 0 0 0 0 0 0 0 0 0 0 0 0 0 0 0 0 0 0 0 0 0 0 0 0 0 
0 0 0 0 0 0 0 0 0 0 0 0 0 0 0 0 0 0 0 0 0 0 0 0 0 0 0 0 0 0 0 0 
0 0 0 0 0 0 0 0 0 0 0 0 0 0 0 0 0 0 0 0 0 0 0 0 0 0 0 0 0 0 0 0 
0 0 0 0 0 0 0 0 0 0 0 0 0 0 0 0 0 0 0 0 0 0 0 0 0 0 0 0 0 0 0 0 
1544 1664 1665 1664 1665 1664 1665 1664 1665 1664 1665 1664 1665 1664 1665 1664 1665 1664 1665 1664 1665 1664 1665 1664 1665 1664 1665 1664 1665 1664 1665 1545 
1546 0 0 0 0 0 0 0 0 0 0 0 0 0 0 0 0 0 0 0 0 0 0 0 0 0 0 0 0 0 0 1543 
1606 0 0 0 0 0 0 0 0 0 0 0 0 0 0 0 0 0 0 0 0 0 0 0 0 0 0 0 0 0 0 1603 
1606 0 0 0 0 0 0 0 0 0 0 0 0 0 0 0 0 0 0 0 0 0 0 0 0 0 0 0 0 0 0 1543 
1546 1613 1614 0 0 0 0 0 0 0 0 0 0 0 0 0 0 0 0 0 0 0 0 0 0 0 0 0 0 0 0 1603 
1604 1485 1486 1619 1620 0 0 0 0 1613 1614 1613 1614 1613 1614 1613 1614 1613 1614 1613 1614 1613 1614 0 0 0 0 0 0 0 0 1543 
1544 1665 1666 0 0 0 0 0 0 0 0 0 0 0 0 0 0 0 0 0 0 0 0 0 0 0 0 1613 1614 1613 1614 1603 
1606 0 0 0 0 0 0 0 0 0 0 0 0 0 0 0 0 0 0 0 0 0 0 0 0 1615 1616 1483 1485 1485 1485 1605 
1606 0 0 0 0 0 0 0 0 0 0 0 0 0 0 0 0 0 0 0 0 0 0 0 0 0 0 1543 1423 1425 1426 1423 
1546 1613 1614 1613 1614 0 0 0 0 0 0 1613 1614 0 0 0 0 0 0 1613 1614 1613 1614 0 0 0 0 1663 1665 1665 1665 1545 
1604 1484 1484 1484 1486 0 0 0 0 0 0 1241 1242 0 0 0 0 0 0 0 0 0 0 0 0 0 0 0 0 0 0 1543 
1423 1424 1426 1426 1546 1619 1620 1617 1618 0 0 1301 1302 0 0 0 0 0 0 0 0 0 0 0 0 0 0 0 0 0 0 1603 
1424 1424 1426 1424 1546 0 0 0 0 0 0 1361 1362 0 0 1613 1614 1613 1614 1613 1614 0 0 0 1129 1130 0 0 0 0 0 1543 
1544 1664 1664 1664 1666 0 0 0 0 0 0 1421 1422 0 0 0 0 0 0 0 0 0 0 0 1189 1190 0 0 0 0 0 1603 
1546 0 0 0 0 0 0 1613 1614 1613 1614 1541 1542 0 0 0 0 0 0 0 0 1615 1616 1617 1618 1619 1620 1617 1618 0 0 1603 
1606 0 0 0 0 0 0 1483 1485 1485 1486 1601 1602 0 0 0 0 0 0 0 0 0 0 1241 1242 0 0 0 0 0 0 1543 
1546 0 0 0 0 1615 1616 1543 1426 1426 1606 1661 1662 1613 1614 0 0 0 0 0 0 0 0 1301 1302 0 0 0 0 0 0 1603 
1606 0 0 0 0 0 0 1603 1423 1424 1546 45 46 47 48 0 0 0 0 0 0 1615 1616 1361 1362 0 0 0 0 1615 1616 1543 
1546 1619 1620 0 0 0 0 1543 1426 1424 1606 105 106 107 108 0 0 0 0 0 0 0 0 1541 1542 0 0 0 0 0 0 1603 
1606 0 0 0 0 0 0 1603 1426 1424 1546 165 166 167 168 0 0 0 0 0 0 0 0 1601 1602 0 0 0 0 0 0 1543 
1546 1669 1670 1613 1614 1669 1670 1603 1426 1424 1606 225 226 227 228 1613 1614 1613 1614 1669 1670 1669 1670 1661 1662 1613 1614 1613 1614 1613 1614 1603 
1604 1484 1485 1484 1485 1485 1484 1605 1425 1424 1604 1485 1484 1485 1484 1484 1485 1484 1485 1484 1485 1484 1485 1484 1485 1484 1485 1484 1485 1484 1485 1605
