TILEMAP
32 26 							-- Size of tile map in tiles
8 8 							-- Tile size & block size
images/Tiles.png 	-- Tilesheet
60 28 								-- Number of tiles in tilesheet
0 0 0 0 0 0 0 0 0 0 0 0 0 0 0 0 0 0 0 0 0 0 0 0 0 0 0 0 0 0 0 0 
0 0 0 0 0 0 0 0 0 0 0 0 0 0 0 0 0 0 0 0 0 0 0 0 0 0 0 0 0 0 0 0 
0 0 0 0 0 0 0 0 0 0 0 0 0 0 0 0 0 0 0 0 0 0 0 0 0 0 0 0 0 0 0 0 
0 0 0 0 0 0 0 0 0 0 0 0 0 0 0 0 0 0 0 0 0 0 0 0 0 0 0 0 0 0 0 0 
1544 1664 1665 1664 1665 1664 1665 1664 1665 1664 1665 1664 1665 1664 1665 1664 1665 1664 1665 1664 1665 1664 1665 1664 1665 1664 1665 1664 1665 1664 1665 1545 
1546 0 0 0 0 0 0 0 0 0 0 0 0 0 0 1543 1606 0 0 0 0 0 0 0 0 0 0 0 0 0 0 1603 
1606 0 0 0 0 0 0 0 0 0 0 0 0 0 0 1603 1546 0 0 0 0 0 0 0 0 0 0 0 0 0 0 1543 
1546 0 0 0 0 0 0 0 0 0 0 0 0 0 0 1663 1666 0 0 0 0 0 0 0 0 0 0 0 0 0 0 1603 
1606 0 0 0 0 0 0 0 0 1241 1242 0 0 0 0 0 0 0 0 0 0 1241 1242 0 0 0 0 0 0 0 0 1543 
1546 0 0 0 0 0 0 0 0 1301 1302 0 0 0 0 0 0 0 0 0 0 1301 1302 0 0 0 0 0 0 0 0 1603 
1606 0 0 0 0 0 0 0 0 1361 1362 1613 1614 1613 1614 0 0 1613 1614 1613 1614 1361 1362 0 0 0 0 0 0 0 0 1543 
1546 0 0 0 0 0 0 0 0 1241 1242 0 0 0 0 0 0 0 0 0 0 1241 1242 0 0 0 0 0 0 0 0 1603 
1606 1613 1614 1613 1614 1613 1614 0 0 1301 1302 0 0 0 0 0 0 0 0 0 0 1301 1302 0 0 1613 1614 1613 1614 1613 1614 1543 
1604 1484 1485 1484 1485 1484 1486 0 0 1361 1362 1619 1620 0 0 0 0 0 0 1615 1616 1361 1362 0 0 1483 1485 1484 1485 1484 1485 1605 
1363 1426 1363 1363 1426 1424 1546 0 0 1421 1422 0 0 0 0 0 0 0 0 0 0 1421 1422 0 0 1603 1423 1426 1363 1363 1426 1364 
1544 1664 1665 1664 1665 1664 1666 0 0 1241 1242 1613 1614 1613 1614 1613 1614 1613 1614 1613 1614 1241 1242 0 0 1663 1665 1664 1665 1664 1665 1545 
1606 0 0 0 0 0 0 0 0 1301 1302 0 0 0 0 0 0 0 0 0 0 1301 1302 0 0 0 0 0 0 0 0 1543 
1546 0 0 0 0 0 0 0 0 1361 1362 0 0 0 0 0 0 0 0 0 0 1361 1362 0 0 0 0 0 0 0 0 1603 
1606 0 0 0 0 0 0 0 0 1421 1422 1613 1614 1613 1614 1613 1614 1613 1614 1613 1614 1421 1422 0 0 0 0 0 0 0 0 1543 
1546 0 0 0 0 0 0 0 0 1541 1542 0 0 0 0 0 0 0 0 0 0 1541 1542 0 0 0 0 0 0 0 0 1603 
1606 1613 1614 1613 1614 1613 1614 0 0 1601 1602 0 0 0 0 0 0 0 0 0 0 1601 1602 0 0 1613 1614 1613 1614 1613 1614 1543 
1546 0 0 0 0 0 0 0 0 1661 1662 1613 1614 1613 1614 1613 1614 1613 1614 1613 1614 1661 1662 0 0 0 0 0 0 0 0 1603 
1606 0 0 0 0 0 0 0 0 0 0 0 0 0 0 0 0 0 0 0 0 0 0 0 0 0 0 0 0 0 0 1543 
1546 0 0 0 0 0 0 0 0 0 0 0 0 0 0 0 0 0 0 0 0 0 0 0 0 0 0 0 0 0 0 1603 
1606 1669 1670 1669 1670 1669 1670 1613 1614 1613 1614 1613 1614 1613 1614 1613 1614 1613 1614 1613 1614 1613 1614 1613 1614 1669 1670 1669 1670 1669 1670 1543 
1604 1484 1485 1484 1485 1484 1485 1484 1485 1484 1485 1484 1485 1484 1485 1484 1485 1484 1485 1484 1485 1484 1485 1484 1485 1484 1485 1484 1485 1484 1485 1605
