TILEMAP
32 26 							-- Size of tile map in tiles
8 8 							-- Tile size & block size
images/Tiles.png 	-- Tilesheet
60 28 								-- Number of tiles in tilesheet
1544 1664 1665 1664 1665 1664 1665 1664 1665 1664 1665 1664 1665 1664 1665 1664 1665 1664 1665 1664 1665 1664 1665 1664 1665 1664 1665 1664 1665 1664 1665 1545 
1606 1423 1423 1363 1364 1363 1364 1363 1364 1363 1364 1363 1364 1363 1364 1363 1364 1363 1364 1363 1364 1363 1364 1363 1364 1363 1364 1363 1364 1363 1424 1543 
1606 1423 1363 1364 1364 1363 1364 1363 1364 1363 1364 1363 1364 1363 1364 1363 1364 1363 1364 1363 1364 1363 1364 1363 1364 1363 1364 1363 1364 1363 1364 1543 
1604 1485 1484 1485 1484 1485 1484 1485 1484 1485 1484 1485 1484 1485 1484 1485 1484 1485 1484 1485 1484 1485 1484 1485 1484 1485 1484 1485 1484 1485 1484 1605 
1544 1664 1665 1664 1665 1664 1665 1664 1665 1664 1665 1664 1665 1664 1665 1664 1665 1664 1665 1664 1665 1664 1665 1664 1665 1664 1665 1664 1665 1664 1665 1545 
1546 1231 1232 1552 1351 1351 1351 1351 1351 1352 1552 1354 1351 1351 1351 1351 1351 1351 1235 1236 1351 1552 1352 1353 1354 1351 1352 1353 1552 1355 1356 1603 
1606 1291 1292 1612 1411 1411 1411 1411 1411 1412 1612 1414 1411 1411 1411 1411 1411 1411 1295 1296 1411 1612 1412 1413 1414 1411 1412 1413 1612 1415 1416 1543 
1546 1471 1471 1672 1471 1471 1471 1471 1471 1472 1672 1474 1471 1235 1236 1471 1471 1471 1471 1471 1471 1672 1472 1473 1474 1317 1318 1473 1672 1475 1476 1603 
1606 1531 1531 1613 1614 1613 1614 1613 1614 1613 1614 1534 1531 1295 1296 1235 1236 1531 1531 1531 1531 1613 1614 1613 1614 1613 1614 1613 1614 1535 1536 1543 
1546 1591 1591 1351 1351 1351 1351 1351 1351 1351 1351 1351 1351 1351 1351 1295 1296 1351 1351 1351 1351 1351 1351 1352 1353 1354 1355 1356 1594 1595 1596 1603 
1606 1352 1353 1411 1411 1411 1411 1411 1411 1411 1411 1411 1411 1411 1411 1411 1411 1411 1411 1411 1411 1411 1411 1412 1413 1414 1415 1416 1474 1596 1597 1543 
1546 1352 1353 1471 1471 1613 1614 1613 1614 1613 1614 1613 1614 1613 1614 1613 1614 1613 1614 1613 1614 1613 1614 1613 1614 1613 1614 1476 1534 1596 1597 1603 
1606 1351 1352 1353 1354 1355 1676 1241 1242 1351 1352 1353 1354 1355 1356 1356 1356 1356 1356 1356 1356 1356 1356 1241 1242 1679 1356 1356 1354 1355 1356 1543 
1546 1411 1412 1413 1414 1415 1416 1301 1302 1352 1353 1354 1355 1356 1476 1476 1351 1352 1353 1617 1618 1615 1616 1301 1302 1416 1416 1416 1414 1415 1416 1603 
1606 1471 1472 1473 1474 1475 1476 1361 1362 1353 1354 1355 1356 1531 1531 1532 1533 1534 1535 1354 1355 1675 1676 1361 1362 1476 1235 1236 1474 1475 1476 1543 
1546 1531 1532 1533 1534 1535 1536 1661 1662 1613 1614 1613 1614 1613 1614 1613 1614 1613 1614 1613 1614 1613 1614 1661 1662 1536 1295 1296 1534 1535 1536 1603 
1606 633 634 635 636 1355 1356 1351 1351 1351 1351 1351 1351 1612 1411 1411 1411 1411 1612 1351 1352 1353 1527 1355 1356 1596 1596 1596 1594 1103 1104 1543 
1546 693 694 695 696 1415 1416 1411 1411 1411 1411 1411 1411 1672 1471 1471 1471 1471 1672 1411 1412 1413 1587 1415 1416 1411 1412 1413 1414 1163 1164 1603 
1606 1613 1614 1613 1614 1613 1614 1471 1471 1471 1471 1471 1471 1613 1614 1613 1614 1613 1614 1471 1472 1473 1647 1475 1476 1613 1614 1613 1614 1613 1614 1543 
1546 1679 1532 1533 1534 1535 1536 879 880 1531 1531 1531 1531 1531 1531 1532 1533 1534 1535 1531 1532 1533 1534 1535 1536 1531 1532 1533 1673 1674 1676 1603 
1606 1351 1351 1351 1351 1351 1351 939 940 1238 1239 1591 1591 1591 1591 1591 1591 1591 1591 1591 1592 1238 1239 1595 1596 1591 1592 1593 1594 1673 1674 1543 
1546 1411 1411 1411 1411 1613 1614 1613 1614 1129 1130 1619 1620 1411 1411 1411 1411 1411 1411 1411 1411 1121 1122 1613 1614 1613 1614 1413 1414 1415 1416 1603 
1606 1524 1525 1471 1471 1471 1471 1471 1471 1189 1190 1679 1680 1471 1471 1471 1471 1471 1471 1129 1130 1181 1182 1231 1232 1471 1472 1473 1474 1235 1236 1543 
1546 1584 1585 1531 1531 1531 1531 1531 1531 1129 1130 1531 1531 1531 1531 1531 1531 1317 1318 1189 1190 1129 1130 1291 1292 1531 1532 1533 1534 1295 1296 1603 
1606 1613 1614 1613 1614 1669 1670 1669 1670 1189 1190 1613 1614 1613 1614 1613 1614 1613 1614 1544 1545 1189 1190 1613 1614 1613 1614 1613 1614 1613 1614 1543 
1604 1484 1485 1484 1485 1484 1485 1484 1485 1484 1485 1484 1485 1484 1485 1484 1485 1484 1485 1484 1485 1484 1485 1484 1485 1484 1485 1484 1485 1484 1485 1605
