TILEMAP
32 26 							-- Size of tile map in tiles
8 8 							-- Tile size & block size
images/Tiles.png 	-- Tilesheet
60 28 								-- Number of tiles in tilesheet
1544 1664 1665 1664 1665 1664 1665 1664 1665 1664 1665 1664 1665 1664 1665 1664 1665 1664 1665 1664 1665 1664 1665 1664 1665 1664 1665 1664 1665 1664 1665 1545 
1606 1423 1423 1363 1364 1363 1364 1363 1364 1363 1364 1363 1364 1363 1364 1363 1364 1363 1364 1363 1364 1363 1364 1363 1364 1363 1364 1363 1364 1363 1424 1543 
1606 1423 1363 1364 1364 1363 1364 1363 1364 1363 1364 1363 1364 1363 1364 1363 1364 1363 1364 1363 1364 1363 1364 1363 1364 1363 1364 1363 1364 1363 1364 1543 
1604 1485 1484 1485 1484 1485 1484 1485 1484 1485 1484 1485 1484 1485 1484 1485 1484 1485 1484 1485 1484 1485 1484 1485 1484 1485 1484 1485 1484 1485 1484 1605 
1544 1664 1665 1664 1665 1664 1665 1664 1665 1664 1665 1664 1665 1664 1665 1664 1665 1664 1665 1664 1665 1664 1665 1664 1665 1664 1665 1664 1665 1664 1665 1545 
1546 1231 1232 1471 1471 1471 1471 1472 1473 1552 1235 1236 1473 1473 1552 1471 1471 1472 1473 1492 1471 1472 1473 25 26 27 28 1473 1492 1231 1232 1603 
1606 1291 1292 1471 1471 1471 1471 1472 1473 1492 1295 1296 1533 1533 1492 1531 1471 1472 1473 1552 1471 1472 1473 85 86 87 88 1533 1552 1291 1292 1543 
1546 1531 1531 1531 1531 1471 1471 1472 1473 1552 1591 1235 1236 1593 1552 1591 1471 1472 1473 1612 1531 1532 1533 145 146 147 148 1593 1612 1474 1474 1603 
1606 1591 1591 1591 1591 1531 1471 1472 1473 1612 1375 1295 1296 1593 1612 1591 1531 1532 1533 1672 1591 1592 1593 205 206 207 208 1593 1672 1474 1474 1543 
1546 1613 1614 1613 1614 1591 1531 1532 1533 1672 1375 1591 1592 1593 1672 1591 1591 1592 1593 1613 1614 1613 1614 1613 1614 1613 1614 1613 1614 1474 1474 1603 
1604 1484 1485 1484 1486 1375 1591 1592 1593 1613 1614 1613 1614 1613 1614 1591 1592 1593 1473 1552 1474 1474 1552 1474 1474 1552 1471 1472 1473 1474 1474 1543 
1423 1363 1363 1424 1546 1619 1620 1376 1471 1472 1473 1221 1222 1355 1612 1591 873 874 1533 1612 1474 1474 1492 1474 1474 1492 1471 1472 1473 1615 1616 1603 
1544 1664 1665 1664 1666 1679 1471 1472 1531 1532 1533 1281 1282 1415 1672 1591 933 934 1593 1672 1474 1474 1552 1474 1474 1552 1471 1472 1473 1675 1676 1543 
1546 1549 1550 1471 1472 1473 1531 1532 1591 1592 1593 1341 1342 1475 1613 1614 1613 1614 1613 1614 1474 1474 1612 1474 1474 1612 1471 1472 1473 1474 1474 1603 
1606 1609 1610 1471 1471 1472 1591 1592 1593 1471 1471 1401 1402 1472 1473 1471 1471 1471 1471 1471 1472 1473 1672 1474 1474 1672 1531 1532 1533 1615 1616 1543 
1546 1471 1472 1531 1531 1532 1533 1123 1124 1531 1531 1581 1582 1532 1533 1531 1531 1499 1500 1531 1532 1533 1613 1614 1613 1614 1591 1592 1593 1675 1676 1603 
1606 1471 1472 1591 1591 1592 1593 1183 1184 1591 1591 1641 1642 1592 1593 1591 1591 1559 1560 1591 1592 1593 1351 1352 1353 1354 1235 1236 1353 1354 1355 1543 
1546 1471 1471 1472 1473 1615 1616 1483 1485 1613 1614 1613 1614 1613 1614 1613 1614 1241 1242 1474 1474 1111 1112 1412 1413 1414 1295 1296 1235 1236 1415 1603 
1606 879 880 1532 1533 1675 1676 1663 1664 1664 1665 1664 1665 1664 1665 1664 1665 1301 1302 1414 1415 1171 1172 1472 1473 1474 1235 1236 1295 1296 1475 1543 
1546 939 940 1592 1593 1471 1471 1471 1528 1471 1471 1471 1471 1472 1473 1612 1474 1361 1362 1619 1620 1617 1618 1532 1533 1534 1295 1296 1533 1534 1535 1603 
1606 1613 1614 1613 1614 1531 1531 1531 1588 1531 1531 1531 1531 1532 1533 1672 1474 1421 1422 1679 1680 1474 1591 1355 1356 1594 1591 1471 1472 1473 1473 1543 
1546 45 46 47 48 1591 1591 1591 1648 1471 1471 1471 1471 1472 1473 1613 1614 1481 1482 1471 1471 1472 1473 1241 1242 1619 1620 1531 1532 1533 1533 1603 
1606 105 106 107 108 1613 1614 1613 1614 1531 1531 1531 1531 1532 1533 1474 1474 1541 1542 1531 1531 1532 1533 1301 1302 1679 1680 1474 1474 1593 1593 1543 
1546 165 166 167 168 529 530 531 532 1591 1591 1591 1591 1592 1593 1474 1474 1601 1602 1591 1591 1592 1593 1361 1362 1474 1474 1474 1474 1123 1124 1603 
1606 225 226 227 228 589 590 591 592 1669 1670 1613 1614 1613 1614 1669 1670 1661 1662 1669 1670 1669 1670 1421 1422 1613 1614 1613 1614 1183 1184 1543 
1604 1484 1485 1484 1485 1484 1485 1484 1485 1484 1485 1484 1485 1484 1485 1484 1485 1484 1485 1484 1485 1484 1485 1484 1485 1484 1485 1484 1485 1484 1485 1605