TILEMAP
32 26 							-- Size of tile map in tiles
8 8 							-- Tile size & block size
images/Tiles.png 	-- Tilesheet
60 28 								-- Number of tiles in tilesheet
1544 1665 1664 1665 1664 1665 1664 1665 1664 1665 1664 1665 1664 1665 1664 1665 1664 1665 1664 1665 1664 1665 1664 1665 1664 1665 1664 1665 1664 1665 1664 1545 
1546 1423 1364 1363 1363 1364 1363 1364 1363 1364 1364 1363 1363 1364 1363 1364 1363 1363 1364 1363 1364 1363 1363 1364 1363 1364 1363 1363 1364 1363 1364 1543 
1606 1423 1363 1363 1364 1363 1363 1364 1363 1364 1363 1364 1363 1364 1363 1364 1363 1364 1363 1364 1363 1363 1363 1363 1364 1363 1363 1363 1364 1363 1364 1603 
1604 1485 1484 1485 1484 1485 1484 1485 1484 1485 1484 1485 1484 1485 1484 1485 1484 1485 1484 1485 1484 1485 1484 1485 1484 1485 1484 1485 1484 1485 1484 1605 
1495 1544 1665 1664 1665 1664 1665 1664 1665 1664 1665 1664 1665 1664 1665 1664 1665 1664 1665 1664 1665 1664 1665 1664 1665 1664 1665 1664 1665 1664 1545 1495 
1544 1546 1231 1232 1492 1255 1552 1255 1492 21 22 23 24 1255 1255 1255 1255 1255 1255 1255 1255 1255 1256 1492 1255 1552 1255 1492 867 868 1543 1545 
1546 1546 1291 1292 1552 1315 1492 1255 1552 81 82 83 84 1255 1255 1255 1255 1255 1255 1255 1255 1255 1256 1552 1315 1492 1315 1552 927 928 1603 1603 
1606 1606 1375 1376 1492 1315 1552 1255 1612 141 142 143 144 1315 1315 1315 1315 1315 1315 1315 1353 1354 1316 1612 1315 1552 1255 1492 1375 1376 1543 1543 
1546 1546 1255 1256 1552 1315 1492 1255 1672 201 202 203 204 1375 1375 1375 1375 1375 1375 1375 1413 1414 1376 1672 1315 1492 1315 1552 1255 1256 1603 1603 
1606 1606 1315 1316 1492 1315 1552 1255 1613 1614 1613 1614 1613 1614 1613 1614 1613 1614 1613 1614 1613 1614 1613 1614 1315 1552 1255 1492 1315 1316 1543 1543 
1546 1546 1375 1376 1552 1315 1612 1255 1255 1255 1255 1255 1255 1612 1483 1484 1485 1486 1612 1255 1255 1255 1255 1255 1315 1612 1315 1552 1375 1376 1603 1603 
1606 1606 1255 1256 1492 1315 1672 1315 1315 1315 1315 1315 1315 1672 1543 1544 1545 1546 1672 1315 1315 1315 1315 1315 1315 1672 1255 1492 1255 1256 1543 1543 
1546 1546 1315 1316 1552 1315 1613 1614 1613 1614 1613 1614 1613 1614 1603 1604 1605 1606 1613 1614 1613 1614 1613 1614 1613 1614 1315 1552 1315 1316 1603 1603 
1606 1606 1375 1376 1612 753 754 755 756 1255 1255 1255 1255 1612 1543 1544 1545 1546 1612 1255 1255 1255 1255 1255 1221 1222 1255 1612 1375 1376 1543 1543 
1546 1546 1255 1256 1672 813 814 815 816 1315 1315 1315 1315 1672 1603 1604 1605 1606 1672 1315 1315 1315 1315 1315 1281 1282 1315 1672 1255 1256 1603 1603 
1606 1606 1315 1316 1613 1614 1613 1614 1613 1614 1613 1614 1613 1614 1663 1664 1665 1666 1613 1614 1613 1614 1613 1614 1613 1614 1613 1614 1315 1316 1543 1543 
1546 1546 1375 1376 1612 1255 1255 1612 1255 1255 1255 1255 1255 1255 1255 1255 1255 1255 1255 1255 1255 1221 1222 1256 1612 1255 1255 1612 1375 1376 1603 1603 
1606 1606 1375 1376 1672 1315 1315 1672 1315 1315 1315 1315 1315 1315 1315 1315 1315 1235 1236 1315 1255 1281 1282 1316 1672 1315 1315 1672 1255 1256 1543 1543 
1546 1546 1255 1256 1613 1614 1613 1614 1375 1375 1375 1375 1375 1375 1375 1375 1235 1236 1235 1236 1315 1341 1342 1376 1613 1614 1613 1614 1315 1316 1603 1603 
1606 1606 1315 1316 1612 1612 1255 1256 1315 1375 1375 1375 1375 1375 1376 1315 1295 1296 1295 1296 1375 1401 1402 1255 1255 1256 1612 1612 1375 1376 1543 1543 
1546 1546 1375 1376 1672 1672 1315 1316 1375 1375 1375 1375 1375 1375 1375 1375 1375 1375 1315 1315 1375 1461 1462 1315 1255 1256 1672 1672 1375 1376 1603 1603 
1606 1606 1255 1256 1613 1614 1255 1255 1255 1255 1255 1255 1255 1255 1255 1255 1255 1255 1375 1375 1375 1521 1522 1375 1255 1256 1613 1614 1255 1256 1543 1543 
1546 1546 1315 1316 1255 1255 1315 1463 1466 1315 1315 1315 1315 1315 1315 1315 1315 1315 1315 1315 1315 1581 1582 1375 1315 1316 1255 1255 1315 1316 1603 1603 
1606 1606 1375 1376 1315 1315 1375 1643 1646 1375 1375 1375 1375 1375 1375 1375 1375 1375 1375 1375 1375 1641 1642 1375 1375 1376 1315 1315 1375 1376 1543 1543 
1604 1546 1613 1614 1613 1614 1613 1614 1613 1614 1613 1614 1669 1670 1669 1670 1669 1670 1669 1670 1613 1614 1613 1614 1613 1614 1613 1614 1613 1614 1543 1605 
1495 1604 1484 1485 1484 1485 1484 1485 1484 1485 1484 1485 1484 1485 1484 1485 1484 1485 1484 1485 1484 1485 1484 1485 1484 1485 1484 1485 1484 1485 1605 1495
