TILEMAP
32 26 							-- Size of tile map in tiles
8 8 							-- Tile size & block size
images/Tiles.png 	-- Tilesheet
60 28 								-- Number of tiles in tilesheet
1544 1664 1665 1664 1665 1664 1665 1664 1665 1664 1665 1664 1665 1664 1665 1664 1665 1664 1665 1664 1665 1664 1665 1664 1665 1664 1665 1664 1665 1664 1665 1545 
1606 1423 1423 1363 1364 1363 1364 1363 1364 1363 1364 1363 1364 1363 1364 1363 1364 1363 1364 1363 1364 1363 1364 1363 1364 1363 1364 1363 1364 1363 1424 1543 
1606 1423 1363 1364 1364 1363 1364 1363 1364 1363 1364 1363 1364 1363 1364 1363 1364 1363 1364 1363 1364 1363 1364 1363 1364 1363 1364 1363 1364 1363 1364 1543 
1604 1485 1484 1485 1484 1485 1484 1485 1484 1485 1484 1485 1484 1485 1484 1485 1484 1485 1484 1485 1484 1485 1484 1485 1484 1485 1484 1485 1484 1485 1484 1605 
1544 1664 1665 1664 1665 1664 1665 1664 1665 1664 1665 1664 1665 1664 1665 1664 1665 1664 1665 1664 1665 1664 1665 1664 1665 1664 1665 1664 1665 1664 1665 1545 
1546 1411 1411 1528 1411 1411 1235 1236 1411 1411 1412 1413 1414 1411 1411 1411 1411 1411 1411 1411 1411 387 388 1411 1411 1411 1412 1413 1414 1549 1550 1603 
1606 1471 1471 1588 1473 1471 1295 1296 1471 1411 1411 29 30 31 32 1471 1471 1471 1471 1471 1471 447 448 1471 1471 1471 1472 1473 1474 1609 1610 1543 
1546 1531 1531 1587 1533 1235 1236 1531 1531 1241 1242 89 90 91 92 1531 1531 1531 1531 1531 1531 1241 1242 1531 1531 1531 1532 1533 1534 1535 1536 1603 
1606 1591 1591 1587 1593 1295 1296 1415 1416 1301 1302 149 150 151 152 1591 1591 1591 1411 1412 1413 1301 1302 1412 1235 1236 1235 1236 1594 1595 1596 1543 
1546 1651 1411 1587 1593 1414 1415 1416 1416 1361 1362 209 210 211 212 1651 1651 1651 1411 1412 1413 1361 1362 1412 1295 1296 1295 1296 1654 1655 1656 1603 
1606 1411 1412 1647 1593 1415 1416 1416 1476 1241 1242 1613 1614 1613 1614 1416 1416 1613 1614 1613 1614 1241 1242 1411 1412 1235 1236 1415 1416 1596 1597 1543 
1546 1411 1412 1413 1593 1415 1416 1476 1536 1301 1302 1536 1536 1536 1536 1476 1476 1476 1476 1476 1476 1301 1302 1411 1412 1295 1296 1415 1416 1596 1597 1603 
1606 1411 1411 1411 1411 1411 1411 1412 1413 1361 1362 1619 1620 1596 1596 1536 1536 1536 1536 1615 1616 1361 1362 1411 1412 1411 1412 1413 1414 1415 1416 1543 
1546 1471 1471 1471 1471 1471 1411 1412 1413 1421 1422 1679 1680 1656 1656 1596 1596 1596 1596 1675 1676 1421 1422 1411 1412 1413 1414 1415 1416 1416 1416 1603 
1606 1669 1670 1669 1669 1670 1411 1412 1413 1241 1242 1613 1614 1613 1614 1613 1614 1613 1614 1613 1614 1241 1242 1411 1412 1413 1669 1669 1670 1670 1670 1543 
1604 1484 1485 1484 1485 1486 1415 1416 1416 1301 1302 1416 1472 1472 1472 1472 1472 1412 1411 1471 1591 1301 1302 1471 1411 1413 1483 1484 1485 1485 1485 1605 
1423 1424 1425 1426 1425 1606 1416 1416 1476 1361 1362 1223 1224 1532 1532 1532 1532 1472 1471 1531 1651 1361 1362 1531 1471 1473 1543 1475 1423 1423 1423 1424 
1544 1664 1665 1664 1665 1666 1476 1476 1536 1421 1422 1613 1614 1613 1614 1613 1614 1613 1614 1613 1614 1421 1422 1591 1531 1533 1663 1664 1665 1665 1665 1545 
1606 1549 1550 1533 1221 1222 1536 1536 1596 1541 1542 1596 1416 1416 1416 1416 1416 1416 1591 873 874 1541 1542 1651 1591 1591 1221 1222 1400 1231 1232 1543 
1546 1609 1610 1593 1281 1282 1596 1596 1656 1601 1602 1656 1476 1476 1476 1223 1224 1476 1651 933 934 1601 1602 1655 1651 1651 1281 1282 1460 1291 1292 1603 
1606 1651 1652 1653 1341 1342 1656 1656 1413 1661 1662 1613 1614 1613 1614 1613 1614 1613 1614 1613 1614 1661 1662 1476 1476 1476 1341 1342 1400 1416 1416 1543 
1546 1613 1614 1473 1521 1522 1471 1472 1473 1474 1471 1472 1473 1474 1471 1472 1473 1471 1472 1473 1474 1475 1476 1536 1536 1536 1521 1522 1460 1613 1614 1603 
1606 1531 1532 1533 1581 1582 1531 1532 1533 1534 1531 879 880 1534 1531 1532 1533 1531 1532 1533 1534 505 506 507 508 1596 1581 1582 1520 1536 1536 1543 
1546 1591 1592 1593 1641 1642 1591 1592 1593 1594 1591 939 940 1594 1591 1005 1006 1591 1592 1593 1594 565 566 567 568 1656 1641 1642 1580 1596 1596 1603 
1606 1669 1670 1669 1670 1669 1670 1613 1614 1613 1614 1613 1614 1613 1614 1065 1066 1613 1614 1613 1614 1613 1614 1613 1614 1669 1670 1669 1670 1669 1670 1543 
1604 1484 1485 1484 1485 1484 1485 1484 1485 1484 1485 1484 1485 1484 1485 1484 1485 1484 1485 1484 1485 1484 1485 1484 1485 1484 1485 1484 1485 1484 1485 1605
