TILEMAP
32 22 							-- Size of tile map in tiles
8 8 							-- Tile size & block size
images/Tiles.png 	-- Tilesheet
60 28 								-- Number of tiles in tilesheet
1544 1664 1665 1664 1665 1664 1665 1664 1665 1664 1665 1664 1665 1664 1665 1664 1665 1664 1665 1664 1665 1664 1665 1664 1665 1664 1665 1664 1665 1664 1665 1545 
1546 1231 1232 1379 1380 1377 1378 1379 1380 1552 1377 1529 1530 1380 1377 1281 1282 1377 1377 1378 1379 1380 1552 1493 1494 1493 1494 1317 1318 1317 1318 1543 
1606 1291 1292 1439 1440 1437 1438 1439 1440 1612 1377 1529 1530 1380 1437 1341 1342 1437 1437 1499 1500 1440 1612 1553 1554 1553 1554 21 22 23 24 1603 
1546 1255 1256 1377 1378 1379 1379 1380 1380 1672 1437 1589 1590 1440 1437 1401 1402 1440 1437 1559 1560 1440 1672 1613 1614 1613 1614 81 82 83 84 1543 
1604 1485 1486 1619 1620 1439 1439 1440 1440 1375 1376 1375 1376 1375 1376 1375 1376 1375 1376 1375 1376 1375 1376 1673 1674 1673 1674 141 142 143 144 1603 
1544 1665 1666 1679 1680 1379 1379 1380 1493 1477 1478 1493 1493 1493 1493 1552 1494 1492 1377 1378 1379 1380 1492 1673 1673 1529 1530 201 202 203 204 1543 
1606 1473 1474 1475 1476 1438 1439 1440 1553 1539 1540 1493 1553 1493 1553 1492 1494 1552 1437 1438 1439 1440 1552 1493 1493 1589 1590 1255 1256 1255 1256 1603 
1546 757 758 759 760 1378 1379 1380 1613 1539 1540 1553 1613 1553 1613 1552 1554 1612 1377 1378 1379 1380 1612 1553 1553 1615 1616 1483 1485 1485 1485 1605 
1606 817 818 819 820 1438 1439 1440 1673 1599 1600 1613 1673 1613 1673 1492 1614 1672 1437 1438 1439 1440 1672 1613 1613 1675 1676 1543 1423 1425 1426 1423 
1546 1255 1256 1255 1256 1493 1494 1494 1533 1659 1660 1255 1256 1474 1673 1552 1674 1255 1256 1255 1256 1255 1256 1673 1673 1673 1674 1663 1665 1665 1665 1545 
1604 1484 1484 1484 1486 983 984 1554 1554 1554 1554 1241 1242 1474 1494 1612 1494 1494 1492 1493 1494 1494 1494 1494 1494 1494 1494 1477 1478 1549 1550 1543 
1423 1424 1426 1426 1546 1043 1044 1614 1614 1614 1614 1301 1302 1474 1554 1672 1494 1554 1672 1493 1554 1554 1554 1554 1554 1554 1554 1539 1540 1609 1610 1603 
1424 1424 1426 1424 1546 1619 1620 1617 1618 1533 1493 1361 1362 1474 1614 1255 1256 1257 1258 1553 1614 1553 1554 1614 1129 1130 1614 1599 1600 1614 1614 1543 
1544 1664 1664 1664 1666 1680 1493 1493 1493 1493 1673 1421 1422 1493 1494 1494 1493 1221 1222 1613 1674 1613 1614 1377 1189 1190 1380 1659 1660 1674 1674 1603 
1546 1549 1550 1281 1282 1380 1613 1255 1256 1255 1256 1541 1542 1613 1613 1613 1613 1341 1342 1553 1553 1617 1618 1615 1616 1617 1618 1619 1620 1553 1554 1603 
1606 1609 1610 1341 1342 1440 1673 1483 1485 1485 1486 1601 1602 1673 1673 1673 1673 1401 1402 1613 1613 1613 1553 1675 1676 1241 1242 1679 1680 1529 1530 1543 
1546 1619 1620 1617 1618 1529 1530 1543 1426 1426 1606 1661 1662 1299 1300 1474 1674 1461 1462 1673 1673 1673 1613 1613 1614 1301 1302 1613 1613 1589 1590 1603 
1606 1679 1680 1521 1522 1589 1590 1603 1423 1424 1546 45 46 47 48 1474 1494 1521 1522 1673 1674 1617 1618 1615 1616 1361 1362 1673 1673 1615 1616 1543 
1546 1377 1378 1581 1582 1615 1616 1543 1426 1424 1606 105 106 107 108 1474 1580 1581 1582 1554 1554 1554 1554 1675 1676 1541 1542 983 984 1675 1676 1603 
1606 1377 1378 1641 1642 1675 1676 1603 1426 1424 1546 165 166 167 168 1474 1640 1641 1642 1493 1494 1493 1496 1497 1498 1601 1602 1043 1044 1613 1614 1543 
1546 1669 1670 1257 1258 1669 1670 1603 1426 1424 1606 225 226 227 228 1255 1256 1255 1256 1669 1670 1669 1670 1669 1670 1661 1662 1255 1256 1257 1258 1603 
1604 1484 1485 1484 1485 1485 1484 1605 1425 1424 1604 1485 1484 1485 1484 1484 1485 1484 1485 1484 1485 1484 1485 1484 1485 1484 1485 1484 1485 1484 1485 1605