TILEMAP
32 26 							-- Size of tile map in tiles
8 8 							-- Tile size & block size
images/Tiles.png 	-- Tilesheet
60 28 								-- Number of tiles in tilesheet
1544 1664 1665 1664 1665 1664 1665 1664 1665 1664 1665 1664 1665 1664 1665 1664 1665 1664 1665 1664 1665 1664 1665 1664 1665 1664 1665 1664 1665 1664 1665 1545 
1606 1423 1423 1363 1364 1363 1364 1363 1364 1363 1364 1363 1364 1363 1364 1363 1364 1363 1364 1363 1364 1363 1364 1363 1364 1363 1364 1363 1364 1363 1424 1543 
1606 1423 1363 1364 1364 1363 1364 1363 1364 1363 1364 1363 1364 1363 1364 1363 1364 1363 1364 1363 1364 1363 1364 1363 1364 1363 1364 1363 1364 1363 1364 1543 
1604 1485 1484 1485 1484 1485 1484 1485 1484 1485 1484 1485 1484 1485 1484 1485 1484 1485 1484 1485 1484 1485 1484 1485 1484 1485 1484 1485 1484 1485 1484 1605 
1544 1664 1665 1664 1665 1664 1665 1664 1665 1664 1665 1664 1665 1664 1665 1664 1665 1664 1665 1664 1665 1664 1665 1664 1665 1664 1665 1664 1665 1664 1665 1545 
1546 1352 1527 1354 1355 1552 1357 1472 1472 1472 1472 1472 1472 1472 1492 1472 1472 1492 1472 1221 1222 1532 1532 1412 1413 1414 1552 1416 1415 1549 1550 1603 
1606 1352 1587 1354 1355 1612 1357 1235 1236 1532 1532 1532 1532 1532 1552 1532 1532 1552 1532 1281 1282 1592 1592 1472 1473 1474 1612 1476 1475 1609 1610 1543 
1546 1352 1587 1354 1355 1552 1357 1295 1296 1235 1236 1352 1352 1352 1612 1352 1352 1612 1352 1341 1342 1354 1355 1235 1236 1534 1552 1536 1357 1536 1534 1603 
1606 1352 1588 1354 1355 1612 1357 1235 1236 1295 1296 1412 1412 1412 1672 1412 1412 1672 1412 1401 1402 1353 1235 1236 1296 1594 1612 1596 1357 1596 1597 1543 
1546 1352 1648 1354 1355 1552 1357 1295 1296 1472 1472 1472 1472 1472 1613 1614 1613 1614 1472 1521 1522 1413 1295 1296 1416 1414 1552 1594 1414 1596 1597 1603 
1606 1352 1353 1354 1355 1612 1357 1352 1352 1532 1532 1532 1532 1532 1612 1532 1532 1612 1532 1581 1582 1473 1474 1475 1476 1474 1612 1594 1474 1596 1597 1543 
1546 1352 1353 1354 1355 1672 1357 1412 1412 1592 1592 1592 1592 1592 1672 1592 1592 1672 1592 1641 1642 1533 1534 1535 1536 1534 1672 1594 1534 1596 1597 1603 
1606 1352 1353 1354 1355 1613 1614 1613 1614 1613 1614 1613 1614 1613 1614 1412 1412 1613 1614 1613 1614 1613 1614 1613 1614 1613 1614 1594 1597 1596 1597 1543 
1546 1619 1620 1354 1355 1356 1357 1532 1352 1483 1486 1355 1356 1472 1472 1472 1472 1472 1352 1353 1354 1483 1486 1412 1352 1592 1593 1594 1595 1615 1616 1603 
1606 1679 1680 1354 1412 1412 1412 1413 1414 1543 1606 1532 1412 1412 1412 1412 1412 1412 1413 1414 1415 1543 1606 1412 1413 1414 1415 1594 1595 1675 1676 1543 
1546 1352 1353 1354 1472 1472 1412 1412 1412 1543 1606 1412 1472 1472 1472 1472 1472 1412 1412 1412 1412 1543 1606 1472 1473 1474 1475 1594 1595 1596 1597 1603 
1606 1613 1614 1613 1614 1613 1614 1613 1614 1663 1666 1472 1532 1532 1532 1532 1532 1472 1472 1472 1472 1663 1666 1613 1614 1613 1614 1613 1614 1613 1614 1543 
1546 1231 1232 1354 1355 1356 1532 1532 1532 1521 1522 1532 1532 1533 1534 1535 1472 1532 1532 1532 1532 1521 1522 1532 1533 1534 1535 1594 1595 1596 1597 1603 
1606 1291 1292 1354 1355 1356 1532 1532 1532 1521 1522 1532 1532 1613 1614 1613 1614 1613 1614 1532 1532 1521 1522 1532 1533 1534 1593 1594 1595 1596 1597 1543 
1546 1613 1614 1613 1614 1356 1357 1592 1412 1581 1582 1415 1416 645 646 647 646 647 648 1413 1414 1581 1582 1472 1352 1592 1593 1613 1614 1613 1614 1603 
1606 1412 1412 1412 1412 1352 1352 879 880 1613 1614 1613 1614 705 706 707 706 707 708 1613 1614 1613 1614 1532 1412 1592 1593 1594 1595 1596 1597 1543 
1546 1412 1412 1412 1412 1412 1412 939 940 45 46 47 48 529 530 531 530 531 532 41 42 43 44 1592 1472 1592 1593 1594 1595 1596 1597 1603 
1606 1472 1472 1472 1472 1613 1614 1613 1614 105 106 107 108 589 590 591 590 591 592 101 102 103 104 1613 1614 1613 1614 1594 1595 997 998 1543 
1546 1532 1532 1532 1532 533 534 535 536 165 166 167 168 645 646 647 646 647 648 161 162 163 164 533 534 535 536 1594 1595 1057 1058 1603 
1606 1613 1614 1613 1614 593 594 595 596 225 226 227 228 705 706 707 706 707 708 221 222 223 224 593 594 595 596 1613 1614 1613 1614 1543 
1604 1484 1485 1484 1485 1484 1485 1484 1485 1484 1485 1484 1485 1484 1485 1484 1485 1484 1485 1484 1485 1484 1485 1484 1485 1484 1485 1484 1485 1484 1485 1605
